# # # # #
# .   . #
# # #   #
#     . #
# # # # #

==

+---+---+
| .   . |
+---+   +
|     . |
+---+---+